NO ./textures/wall_n.xpm
SO ./textures/wall_s.xpm
WE ./textures/wall_w.xpm
EA ./textures/wall_e.xpm

F 184,238,255
C 125,96,29

111111
111001
101001
1000N1
111111