NO ./textures/wall_n.xpm
SO ./textures/wall_s.xpm
WE ./textures/wall_w.xpm
EA ./textures/wall_e.xpm

F 125,96,29
C 184,238,255

111111
111001
111001
1  0N1
111111