NO ./textures/wall_n.xpm
SO ./textures/teapot.xpm
WE ./textures/wall_w.xpm
EA ./textures/wall_e.xpm

F 125,96,29
C 184,238,255

111111
100001
111001
1 10N1
111111